....#####
....#...#
....#b..#
..###..b##
..#..b.b.#
###.#.##.#...######
#...#.##.#####..ss#
#.b..b..........ss#
#####.###.#w##..ss#
....#.....#########
....#######
